****************
*S    *     *  *
****  *  *  *  *
*  *     *     *
*  *******  ****
*           *  *
****  ****  *  *
*     *        *
*  *  ****  *  *
*  *  *     *E * 
****************